M        MMMMMMMMMMMMMMMMMMMMMMMMMMMMMMMMMMMMMMMMMMMMMMMMMMMMMMMMMMMMMMMMMMMMMMMMMMMMMMMMMMMMMMMMMMMMMMMMMMMMM
M        MMMMMMMMMMMMMMMMMMMMMMMMMMMMMMMMMMMMMMMMMMMMMMMMMMMMMMMMMMMMMMMMMMMMMMMMMMMMMMMMMMMMMMMMMMMMMMMMMMMMM 
M        MMMMMMMMMMMMMMMMMMMMMMMMMMMVVVVVVVVVVVVVVVVVVVVVVVVVVVVVVVVVVVVVVVVVVVVVVVVVVVVVVVVVVVVVVVVVVMMMMMMMM
M            QMMMMMMMMMMMMMMMMMMMMMP                                                                  MMMMMMMM
M            TVVVVVVVVVVVVVVVVVVVVVU                      l                                           MMMMMMMM
M                                                                    l          l            l        MMMMMMMM
M                                          l                                        KKK               MMMMMMMM
M         l  RLS                 RLS                        KK           KKK   KKK                    MMMMMMMM
M            QMP  u    u    uttttQMP                      KK  KK    KKK                  K          * MMMMMMMM
LLLLLLLLLLLLLOMNLLLLLLLLLLLLLLLLLOMNLLLLLLLLLLLLLLLLLLL                                      K   K  LLMMMMMMMM
MMMMMMMMMMMMMMMMMMMMMMMMMMMMMMMMMMMMMMMMMMMMMMMMMMMMMMM v v v v v v v v v v v v v v v v v v v v v v MMMMMMMMMM   
MMMMMMMMMMMMMMMMMMMMMMMMMMMMMMMMMMMMMMMMMMMMMMMMMMMMMMMXXXXXXXXXXXXXXXXXXXXXXXXXXXXXXXXXXXXXXXXXXXXXMMMMMMMMMM