F                                                            f                                     I
HF                                                                                                 I
AHF                   g               EBBF       K   h             K      e  b   KKK               I
AAHF                          EBBBBBBBGAAD                                  KKK                    I
AAAHF               *        EGAAAAAAAAAAD               KK           KKK             K          * I
AAAAHBBBBBBBBBBBBBBBBBBBBBBBBGAAAAAAAAAAAHBBBBBBBBBB   KK  KK    KKK                      K   K  KKI
