# Map file for tile-based game
# (Lines that start with '#' are comments)
# The tiles are:
#   (Space) Empty tile
#   A..Z    Tiles A through Z
#   o       Star
#   !       Music Note
#   *       Goal
#   ^	    Health
#   a       Bad Guy a (grub)
#   b       Bad Guy b (fly)
#   c       Bad Guy c (monkey)
#   d	    Boss Guy 
#   0       Warp

AD                                                                                            CA
BF          o o o                o o o o o o o o o o o o o o o o o o o o o o o  CBBBBBBBBBBBBCCA
AD          IIIII       o o o    IIIIIIIIIIIIIIIIIII             EBBBBBBBBBBBBBBD    o o o o  CA
AD                     IIIIIII               I                   CAAAAAAAAAAAAAAD   o o o o o CA
AD                    b   !        b                      IIIII  CAAAAAAAAAAAAAAD   o o o o o CA
AD                                                               HAAAAAAAAAAAAAAH    IIIIIII  CA
AD                IIIIIIIIIII                                                                 CA
AD                                                                                            CA
AD         III                          a    a  a        b       CAAAAAAAAAAAAAAAD  o o o o o CA
AD                            a      IIIIIIIIIIIII               CAAAAAAAAAAAAAAAHF  o o o o  CA
AD                                                               CAAAAAAAAAAAAAAAHF           CA
AD II   a       EBBBBBBBBBBBBBBBF     o o o o o o       a      * CAAAAAAAAAAAAAAAAD o o o o o CA
AHBBBBBBBBBBBBBBGAAAAAAAAAAAAAAAHBBBBBBBBBBBBBBBBBBBBBBBBBBBBBBBBGAAAAAAAAAAAAAAAAHBBBBBBBBBBBGA