# Map file for tile-based game
# (Lines that start with '#' are comments)
# The tiles are:
#   (Space) Empty tile
#   A..Z    Tiles A through Z
#   o       Star
#   !       Music Note
#   *       Goal
#   ^	    Health
#   a       Bad Guy a (grub)
#   b       Bad Guy b (fly)
#   c       Bad Guy c (monkey)
#   d	    Boss Guy 
#   0       Warp

AD                                                                                            CA
BF          & & &                & & & & & & & & & & & & & & & & & & & & & & &  CBBBBBBBBBBBBCCA
AD          IIIII       & & &    IIIIIIIIIIIIIIIIIII             EBBBBBBBBBBBBBBD    & & & &  CA
AD                     IIIIIII               I                   CAAAAAAAAAAAAAAD   & & & & & CA
AD                    b   !        b                      IIIII  CAAAAAAAAAAAAAAD   & & & & & CA
AD                                                               HAAAAAAAAAAAAAAH    IIIIIII  CA
AD                IIIIIIIIIII                                                                 CA
AD                                                                                            CA
AD         III                          a    a  a        b       CAAAAAAAAAAAAAAAD  & & & & & CA
AD                            a      IIIIIIIIIIIII               CAAAAAAAAAAAAAAAHF  & & & &  CA
AD                                                               CAAAAAAAAAAAAAAAHF           CA
AD II   a       EBBBBBBBBBBBBBBBF     & & & & & &       a      * CAAAAAAAAAAAAAAAAD & & & & & CA
AHBBBBBBBBBBBBBBGAAAAAAAAAAAAAAAHBBBBBBBBBBBBBBBBBBBBBBBBBBBBBBBBGAAAAAAAAAAAAAAAAHBBBBBBBBBBBGA